
profondo	Adjetivos
dolci	Adjetivos
profonda	Adjetivos
leggere	Adjetivos
futura	Adjetivos
leggera	Adjetivos
differenti	Adjetivos
differente	Adjetivos
leggero	Adjetivos
caffè	Comida
la	Determinativos
nel	Preposicion
pasta	Comida
di	Preposicion
per	Preposicion
troppo	Adverbio
mi	Pronombres
così	Adverbio
questa	Determinativos
dolce	Adjetivos
in	Preposicion
questi	Determinativos
le	Determinativos
tua	Pronombres
si	Pronombres
una	Determinativos
il	Determinativos
ma	Conjunction
un	Determinativos
i	Determinativos
non	Adverbio
mio	Determinativos
piatto	Cocina
come	Adverbio
semplice	Adjetivos
superiori	Adjetivos
vicino	Adjetivos
scorso	Adjetivos
fisica	Adjetivos
superiore	Adjetivos
vicina	Adjetivos
scorsa	Adjetivos
simili	Adjetivos
fisici	Adjetivos
fondamentale	Adjetivos
simile	Adjetivos
vicini	Adjetivos
semplici	Adjetivos
te	Pronombres
miei	Pronombres
a	Preposicion
alla	Preposicion
mia	Determinativos
gli	Determinativos
noi	Pronombres
animali	Animales		
assolutamente	Adverbio
nell'	Preposicion
voi	Pronombres
dallo	Preposicion
personali	Adjetivos
particolare	Adjetivos
povera	Adjetivos
necessario	Adjetivos
particolari	Adjetivos
grave	Adjetivos
poveri	Adjetivos
necessari	Adjetivos
naturale	Adjetivos
personale	Adjetivos
naturali	Adjetivos
generale	Adjetivos
certo	Adverbio
no	Adverbio
c'	Adverbio
sì	Adverbio
con	Preposicion
latte	Noun
lei	Pronombres
niente	Adverbio
lui	Pronombres
numerose	Adjetivos
cattiva	Adjetivos
originale	Adjetivos
seguente	Adjetivos
recenti	Adjetivos
finale	Adjetivos
definitiva	Adjetivos
cattivo	Adjetivos
definitivi	Adjetivos
recente	Adjetivos
originali	Adjetivos
numerosa	Adjetivos
seguenti	Adjetivos
cattivi	Adjetivos
mela	Noun
insomma	Adverbio
quasi	Adverbio
chi	Pronombres
succo	Noun
l'	Determinativos
giornali	Noun
più	Adverbio
quella	Determinativos
ancora	Adverbio
professionale	Adjetivos
avanzata	Adjetivos
responsabile	Adjetivos
professionali	Adjetivos
commerciale	Adjetivos
commerciali	Adjetivos
responsabili	Adjetivos
principale	Adjetivos
efficaci	Adjetivos
legale	Adjetivos
efficace	Adjetivos
avanzato	Adjetivos
legali	Adjetivos
dov'	Adverbio
tuo	Determinativos
età	Noun
quanto	Pronombres
troppi	Determinativos
uomini	Noun
ci	Pronombres
qual	Adjetivos
cavalli	Noun
indipendente	Adjetivos
pura	Adjetivos
industriale	Adjetivos
attenti	Adjetivos
indipendenti	Adjetivos
migliore	Adjetivos
attenta	Adjetivos
veloce	Adjetivos
fresca	Adjetivos
migliori	Adjetivos
fresco	Adjetivos
puro	Adjetivos
attento	Adjetivos
giornale	Noun
uno	Determinativos
dei	Preposicion
al	Preposicion
acqua	Noun
nella	Preposicion
loro	Pronombres
sempre	Adverbio
bene	Adverbio
uovo	Noun
alcol	Noun
bottiglia	Noun
questo	Determinativos
frutta	Noun
della	Preposicion
globale	Adjetivos
divertente	Adjetivos
regionale	Adjetivos
pubblica	Adjetivos
statali	Adjetivos
locale	Adjetivos
regionali	Adjetivos
statale	Adjetivos
provinciale	Adjetivos
molto	Adverbio
piatti	Noun
ragazze	Noun
perché	Adverbio
comunità	Noun
nostri	Determinativos
queste	Determinativos
fritto	Adjetivos
pesce	Noun
culturale	Adjetivos
culturali	Adjetivos
negative	Adjetivos
familiari	Adjetivos
positivo	Adjetivos
storico	Adjetivos
tradizionale	Adjetivos
positive	Adjetivos
negativo	Adjetivos
negativa	Adjetivos
positiva	Adjetivos
antica	Adjetivos
storica	Adjetivos
familiare	Adjetivos
antico	Adjetivos
storici	Adjetivos
antichi	Adjetivos
durante	Preposicion
o	Conjunction
lo	Determinativos
io	Pronombres
cosa	Pronombres
due	Numeral
dove
pranzo	Noun
mai	Adverbio
da	Preposicion
bottiglie	Noun
gatti	Noun
oggi	Adverbio
birra	Noun
già	Adverbio
qui	Adverbio
allo	Preposicion
vi	Pronombres
manzo	Noun
solo	Adverbio
senza	Preposicion
quarant'	Numeral
tre	Numeral
ti	Pronombres
ristorante	Noun
del	Preposicion
donne	Noun
donna	Noun
che	Conjunction
me	Pronombres
zoo	Noun
un'	Determinativos
ieri	Adverbio
ovunque	Adverbio
suo	Determinativos
mercoledì	Noun
fa	Adverbio
li	Pronombres
pochino	Noun
appena	Adverbio
zuppa	Noun
quel	Determinativos
troppa	Determinativos
ogni	Determinativos
quest'	Determinativos
diverse	Determinativos
diversi	Determinativos
quelli	Determinativos
certa	Determinativos
quegli	Determinativos
tutti	Determinativos
qualunque	Determinativos
troppe	Determinativos
quei	Determinativos
parecchie	Determinativos
nessun	Determinativos
quelle	Determinativos
parecchi	Determinativos
certi	Determinativos
nessuna	Determinativos
quello	Determinativos
tutto	Determinativos
quell'	Determinativos
qualche	Determinativos
qualsiasi	Determinativos
parecchia	Determinativos
parecchio	Determinativos
tutta	Determinativos
tutte	Determinativos
altro	Determinativos
altra	Determinativos
certe	Determinativos
metà	Noun
quattordici	Numeral
undici	Numeral
diciannove	Numeral
zero	Numeral
quattro	Numeral
venti	Numeral
sessanta	Numeral
trenta	Numeral
sedici	Numeral
sei	Numeral
cinque	Numeral
dieci	Numeral
otto	Numeral
trent'	Numeral
settant'	Numeral
sessant'	Numeral
ottanta	Numeral
cento	Numeral
diciassette	Numeral
quaranta	Numeral
meno	Adverbio
novanta	Numeral
quindici	Numeral
tredici	Numeral
diciotto	Numeral
abbastanza	Adverbio
settanta	Numeral
nove	Numeral
dodici	Numeral
sette	Numeral
ce	Pronombres
se	Pronombres
ne	Pronombres
personalità	Noun
biscotti	Noun
sulla	Preposicion
anche	Adverbio
bar	Noun
albergo	Noun
edifici	Noun
quale	Pronombres
dentro	Adverbio
insieme	Adverbio
dal	Preposicion
nostra	Determinativos
forse	Adverbio
proprio	Adverbio
però	Adverbio
meglio	Adverbio
lì	Adverbio
dopo	Adverbio
qua	Adverbio
prima	Adverbio
tuttavia	Adverbio
fuori	Adverbio
quando
là	Adverbio
veramente	Adverbio
intorno	Adverbio
completamente	Adverbio
allora	Adverbio
tanto	Adverbio
subito	Adverbio
com'	Adverbio
ovviamente	Adverbio
sopra	Adverbio
poco	Adverbio
almeno	Adverbio
poi	Adverbio
soltanto	Adverbio
davvero	Adverbio
adesso	Adverbio
benissimo	Adverbio
oltre	Adverbio
pure	Adverbio
soprattutto	Adverbio
sotto	Adverbio
neanche	Adverbio
spesso	Adverbio
comunque	Adverbio
piuttosto	Adverbio
circa	Adverbio
sofà	Noun
specialità	Noun
paio	Noun
miglio	Noun
po'	Pronombres
papà	Noun
giovedì	Noun
martedì	Noun
stanotte	Adverbio
settimanalmente	Adverbio
stasera	Adverbio
presto	Adverbio
domani	Adverbio
lunedì	Noun
ora	Adverbio
venerdì	Noun
tardi	Adverbio
stamattina	Adverbio
verso	Preposicion
contro	Preposicion
sulle	Preposicion
tra	Preposicion
nonostante	Preposicion
dagli	Preposicion
dalla	Preposicion
dell'	Preposicion
dello	Preposicion
nelle	Preposicion
sul	Preposicion
delle	Preposicion
all'	Preposicion
dall'	Preposicion
degli	Preposicion
dalle	Preposicion
sui	Preposicion
nei	Preposicion
fino	Preposicion
col	Preposicion
senz'	Preposicion
tranne	Preposicion
lungo	Preposicion
alle	Preposicion
fra	Preposicion
sullo	Preposicion
dai	Preposicion
su	Preposicion
secondo	Preposicion
sull'	Preposicion
entro	Preposicion
negli	Preposicion
ad	Preposicion
agli	Preposicion
d'	Preposicion
finché	Conjunction
ed	Conjunction
bensì	Conjunction
e	Conjunction
mentre	Conjunction
oppure	Conjunction
né	Conjunction
sia	Conjunction
quanti	Pronombres
cos'	Pronombres
quanta	Pronombres
quali	Pronombres
quante	Pronombres
sua	Pronombres
tuoi	Determinativos
tue	Determinativos
mie	Determinativos
propria	Determinativos
nostre	Determinativos
vostre	Determinativos
nostro	Determinativos
vostri	Determinativos
suoi	Determinativos
sue	Determinativos
vostro	Determinativos
propri	Determinativos
patata	Noun
ingrediente	Noun
coltello	Noun
ghiaccio	Noun
cucchiaio	Noun
ricetta	Noun
cameriere	Noun
funghi	Noun
tacchino	Noun
cena	Verb
vegetariano	Noun
limonata	Noun
pranza	Verb
fragola	Noun
griglia	Noun
arancia	Noun
insalata	Noun
panino	Noun
vino	Noun
acido	Adjetivos
cipolla	Noun
tè	Noun
menu	Noun
pasto	Noun
bistecca	Noun
limone	Noun
carne	Noun
olio	Noun
maiale	Noun
pomodoro	Noun
marmellata	Noun
verdura	Noun
pepe	Noun
ceniamo	Verb
sale	Noun
pranzano	Verb
salsiccia	Noun
fame	Noun
riso	Noun
gusto	Noun
delfino	Noun
scimmia	Noun
animale	Noun
mosca	Noun
cavallo	Noun
farfalla	Noun
leone	Noun
gatto	Noun
squalo	Noun
tigre	Noun
serpente	Noun
uccello	Noun
insetto	Noun
balena	Noun
cane	Noun
pinguino	Noun
topo	Noun
tartaruga	Noun
ragno	Noun
mucca	Noun
formica	Noun
orso	Noun
elefante	Noun
anatra	Noun
lupo	Noun
toro	Noun
ape	Noun
mele	Noun
gatte	Noun
forchette	Noun
insetti	Noun
uccelli	Noun
mucche	Noun
banane	Noun
elefanti	Noun
cani	Noun
pesci	Noun
caramelle	Noun
farfalle	Noun
ai	Preposicion
polli	Noun
bicchieri	Noun
cuochi	Noun
torte	Noun
panini	Noun
banana	Noun
forchetta	Noun
tazza	Noun
cuoco	Noun
bicchiere	Noun
formaggio	Noun
aglio	Noun
crema	Noun
colazione	Noun
cioccolato	Noun
bevanda	Noun
fagiolo	Noun
burro	Noun
biscotto	Noun
pollo	Noun
carota	Noun
taglia	Verb
cibo	Noun
gelato	Noun
taglio	Verb
bolle	Verb
ciotola	Noun
caramella	Noun
torta	Noun
uva	Noun
buongiorno	Interjection
ciao	Interjection
buonasera	Interjection
grazie	Interjection
spiacente	Adjetivos
arrivederci	Interjection
buonanotte	Interjection
prego	Interjection
ragazzi	Noun
nello	Preposicion
tu	Pronombres
ragazzo	Noun
ragazza	Noun
pane	Noun
uomo	Noun
zucchero	Noun
tavolo	Noun
letto	Noun
sapone	Noun
muro	Noun
dentifricio	Noun
divani	Noun
rasoio	Noun
porta	Noun
muri	Noun
divano	Noun
balcone	Noun
scala	Noun
telefoni	Noun
tetto	Noun
specchi	Noun
scale	Noun
docce	Noun
specchio	Noun
doccia	Noun
stanza	Noun
tavola	Noun
casa	Noun
telefono	Noun
riscaldamento	Noun
lampada	Noun
tenda	Noun
frigoriferi	Noun
seggiola	Noun
entrata	Noun
asciugamani	Noun
frigorifero	Noun
mobile	Noun
seggiole	Noun
forno	Noun
mobili	Noun
pavimento	Noun
coperta	Noun
cancelli	Noun
cortile	Noun
sciampo	Noun
vasca	Noun
luci	Noun
cancello	Noun
luce	Noun
cuscino	Noun
scrivania	Noun
cuscini	Noun
scrittrice	Noun
poliziotti	Noun
dottore	Noun
meccanico	Noun
direttore	Noun
scrittore	Noun
direttori	Noun
meccanici	Noun
ingegneri	Noun
segretaria	Noun
dottori	Noun
conduttore	Noun
segretario	Noun
ricercatore	Noun
ricercatori	Noun
poliziotto	Noun
dottoresse	Noun
ricercatrice	Noun
ingegnere	Noun
lavoro	Noun
avvocato	Noun
guardia	Noun
pagliaccio	Noun
architetto	Noun
pescatore	Noun
pagliacci	Noun
contadini	Noun
guardie	Noun
capitano	Noun
lavori	Noun
avvocati	Noun
contadino	Noun
settembre	Noun
notte	Noun
tempo	Noun
minuto	Noun
maggio	Noun
inverno	Noun
minuti	Noun
sandali	Noun
sandalo	Noun
divisa	Noun
pantaloni	Noun
stivale	Noun
maglioni	Noun
guanti	Noun
giacca	Noun
orologio	Noun
gonna	Noun
stivali	Noun
maglione	Noun
quarto	Noun
postini	Noun
litri	Noun
litro	Noun
chilogrammi	Noun
idraulico	Noun
metri	Noun
postino	Noun
chilogrammo	Noun
totale	Noun
operai	Noun
idraulici	Noun
metro	Noun
piccola	Adjetivos
piccolo	Adjetivos
enorme	Adjetivos
centimetro	Noun
centimetri	Noun
coppia	Noun
chilometri	Noun
grammo	Noun
piccoli	Adjetivos
grammi	Noun
doppio	Adjetivos
chilometro	Noun
cognome	Noun
sorelle	Noun
misure	Noun
misura	Noun
sorella	Noun
cognomi	Noun
nome	Noun
mamma	Noun
genitori	Noun
nomi	Noun
nonna	Noun
figlia	Noun
moglie	Noun
figlie	Noun
nonno	Noun
madre	Noun
mogli	Noun
figli	Noun
marito	Noun
zie	Noun
cugino	Noun
zio	Noun
famiglia	Noun
zia	Noun
cugini	Noun
figlio	Noun
primavera	Noun
momento	Noun
sabato	Noun
novembre	Noun
periodo	Noun
luglio	Noun
sera	Noun
calendario	Noun
mattina	Noun
agosto	Noun
aprile	Noun
settimana	Noun
mezzanotte	Noun
secondi	Noun
settimane	Noun
compleanno	Noun
marzo	Noun
pomeriggio	Noun
mese	Noun
ritardo	Noun
festa	Noun
feste	Noun
estate	Noun
ottobre	Noun
ore	Noun
data	Noun
decenni	Noun
date	Noun
febbraio	Noun
decennio	Noun
autunno	Noun
gialli	Adjetivos
colorata	Adjetivos
verde	Adjetivos
grigia	Adjetivos
marrone	Adjetivos
bianco	Noun
grigie	Adjetivos
gialla	Adjetivos
azzurra	Adjetivos
gialle	Adjetivos
azzurre	Adjetivos
grigio	Adjetivos
colorati	Adjetivos
rosa	Adjetivos
viola	Adjetivos
lavora	Verb
possono	Verb
finiamo	Verb
vedo	Verb
arrivi	Verb
chiama	Verb
credo	Verb
vede	Verb
lavorano	Verb
facciamo	Verb
vediamo	Verb
può	Verb
danno	Verb
fai	Verb
faccio	Verb
chiamo	Verb
crede	Verb
ricordo	Verb
aspetto	Verb
venite	Verb
aspettate	Verb
stai	Verb
parla	Verb
aprite	Verb
stanno	Verb
vengono	Verb
prende	Verb
entrate	Verb
entra	Verb
viene	Verb
ricordano	Verb
sta	Verb
parlano	Verb
parli	Verb
vieni	Verb
mettete	Verb
metto	Verb
chiede	Verb
passi	Verb
usiamo	Verb
vivono	Verb
tengono	Verb
trovo	Verb
tenete	Verb
vive	Verb
muore	Verb
diventa	Verb
moriamo	Verb
muoiono	Verb
passano	Verb
divento	Verb
uso	Verb
vivete	Verb
usa	Verb
porti	Verb
trovate	Verb
rimangono	Verb
lasciamo	Verb
lascia	Verb
rimane	Verb
risposta	Noun
domanda	Noun
domande	Noun
vestito	Noun
portafogli	Noun
calze	Noun
tasca	Noun
tasche	Noun
camicie	Noun
cintura	Noun
camicia	Noun
cappelli	Noun
lana	Noun
portafoglio	Noun
calza	Noun
vestiti	Noun
ombrello	Noun
borse	Noun
scarpa	Noun
cappotto	Noun
scarpe	Noun
costume	Noun
abiti	Noun
cuoio	Noun
abito	Noun
maglia	Noun
borsa	Noun
gioielleria	Noun
abbigliamento	Noun
libro	Noun
libri	Noun
asciugo	Verb
friggi	Verb
nuota	Verb
cucina	Verb
cucino	Verb
esploriamo	Verb
prenota	Verb
coltivo	Verb
coltiva	Verb
lava	Verb
fallisco	Verb
riposo	Verb
riempi	Verb
fuma	Verb
pesca	Verb
pescano	Verb
cammini	Verb
viaggia	Verb
rompono	Verb
volo	Verb
disegniamo	Verb
indosso	Verb
visitiamo	Verb
dorme	Verb
siede	Verb
compra	Verb
cantano	Verb
ringrazio	Verb
spinge	Verb
spingiamo	Verb
alcune	Determinativos
alcuna	Determinativos
alcuni	Determinativos
numeri	Noun
primo	Adjetivos
terza	Adjetivos
rapporti	Noun
compagno	Noun
simpatici	Adjetivos
giovane	Noun
carattere	Noun
popolo	Noun
cittadina	Noun
cittadini	Noun
indica	Verb
chiudete	Verb
cambio	Verb
rispondo	Verb
crescono	Verb
colpisci	Verb
scusa	Verb
controllo	Verb
colpiamo	Verb
moderna	Adjetivos
buono	Adjetivos
famosa	Adjetivos
moderni	Adjetivos
breve	Adjetivos
economico	Adjetivos
aperta	Adjetivos
facile	Adjetivos
corte	Adjetivos
prossimo	Adjetivos
difficili	Adjetivos
bravo	Adjetivos
pericoloso	Adjetivos
stranieri	Adjetivos
ricco	Adjetivos
internazionale	Adjetivos
vecchie	Adjetivos
straniera	Adjetivos
nazionale	Adjetivos
popolari	Adjetivos
bello	Adjetivos
bella	Adjetivos
possibile	Adjetivos
interessante	Adjetivos
nuova	Adjetivos
pieno	Adjetivos
dura	Adjetivos
appartamento	Noun
giocattoli	Noun
sedia	Noun
finestre	Noun
dicembre	Noun
giugno	Noun
mezzogiorno	Noun
posso	Verb
potete	Verb
conosciamo	Verb
dice	Verb
grande	Adjetivos
fratello	Noun
padre	Noun
gennaio	Noun
secolo	Noun
anno	Noun
arancioni	Adjetivos
rosso	Adjetivos
decidi	Verb
sento	Verb
piacciono	Verb
dà	Verb
mangiate	Verb
mangiano	Verb
mangiamo	Verb
scrivono	Verb
scrivete	Verb
siete	Verb
scriviamo	Verb
scrivi	Verb
scrive	Verb
siamo	Verb
scrivo	Verb
bevete	Verb
gente	Noun
ospiti	Noun
ospite	Noun
matrimonio	Noun
folla	Noun
adulto	Noun
bambino	Noun
fidanzato	Noun
amica	Noun
benzina	Noun
strumento	Noun
automobili	Noun
batteria	Noun
automobile	Noun
macchine	Noun
fogli	Noun
schermo	Noun
flauto	Noun
ruota	Noun
violino	Noun
oggetto	Noun
oggetti	Noun
flauti	Noun
regalo	Noun
regali	Noun
pezzo	Noun
ventilatore	Noun
pezzi	Noun
scatola	Noun
motore	Noun
spazzola	Noun
scatole	Noun
pettine	Noun
diario	Noun
busta	Noun
computer	Noun
ferroviario	Adjetivos
quartiere	Noun
porto	Noun
provincia	Noun
palazzo	Noun
ferroviaria	Adjetivos
palazzi	Noun
teatri	Noun
villaggio	Noun
strada	Noun
stazione	Noun
teatro	Noun
paesi	Noun
supermercato	Noun
paese	Noun
stadio	Noun
posto	Noun
piazza	Noun
regione	Noun
museo	Noun
prigione	Noun
posti	Noun
parco	Noun
campo	Noun
collina	Noun
centro	Noun
campi	Noun
angolo	Noun
sala	Noun
pasticceria	Noun
edificio	Noun
ponte	Noun
castelli	Noun
castello	Noun
libreria	Noun
cerco	Verb
attraverso	Verb
impari	Verb
preferisce	Verb
dimentichiamo	Verb
salva	Verb
descrivi	Verb
invitiamo	Verb
vende	Verb
invita	Verb
dimentica	Verb
tira	Verb
vendo	Verb
descrive	Verb
salviamo	Verb
studia	Verb
corriamo	Verb
corrono	Verb
gira	Verb
corri	Verb
corro	Verb
manda	Verb
ritorna	Verb
corre	Verb
ritorni	Verb
studio	Verb
ascoltano	Verb
paga	Verb
ascoltiamo	Verb
cade	Verb
cresce	Verb
cresciamo	Verb
paghiamo	Verb
ascolta	Verb
spiega	Verb
cadono	Verb
pagano	Verb
riceve	Verb
dimostra	Verb
aggiungi	Verb
sceglie	Verb
guidiamo	Verb
significa	Verb
manca	Verb
costruiamo	Verb
aiuta	Verb
indichi	Verb
ama	Verb
succede	Verb
chiudi	Verb
provo	Verb
perde	Verb
proviamo	Verb
gioca	Verb
offro	Verb
unisci	Verb
giochiamo	Verb
perdo	Verb
offre	Verb
leggi	Verb
legge	Verb
caldo	Adjetivos
chiara	Adjetivos
fredda	Adjetivos
giusto	Adjetivos
pronta	Adjetivos
giusta	Adjetivos
sicura	Adjetivos
pronto	Adjetivos
comune	Adjetivos
vero	Adjetivos
sicuro	Adjetivos
normale	Adjetivos
prossimi	Adjetivos
corto	Adjetivos
lunga	Adjetivos
intero	Adjetivos
grosso	Adjetivos
forte	Adjetivos
soli	Adjetivos
strana	Adjetivos
pesante	Adjetivos
perfetto	Adjetivos
perfetti	Adjetivos
interessato	Adjetivos
perfetta	Adjetivos
capace	Adjetivos
speciale	Adjetivos
interessata	Adjetivos
speciali	Adjetivos
unico	Adjetivos
elettrica	Adjetivos
quotidiano	Adjetivos
moderno	Adjetivos
importante	Adjetivos
popolare	Adjetivos
utile	Adjetivos
gratuito	Adjetivos
libero	Adjetivos
cari	Adjetivos
bassi	Adjetivos
buon	Adjetivos
buona	Adjetivos
alto	Adjetivos
stesso	Adjetivos
vecchia	Adjetivos
impossibile	Adjetivos
lenzuola	Noun
spazzolino	Noun
finestra	Noun
giocattolo	Noun
compriamo	Verb
chiave	Noun
limpido	Adjetivos
tappeto	Noun
limpida	Adjetivos
tappeti	Noun
nipote	Noun
leggo	Verb
bagno	Noun
leggete	Verb
azzurro	Noun
rosse	Adjetivos
possiamo	Verb
chiediamo	Verb
pensa	Verb
fratelli	Noun
anni	Noun
leggiamo	Verb
giorno	Noun
leggono	Verb
guardate	Verb
conosco	Verb
guarda	Verb
arriva	Verb
arrivo	Verb
guardiamo	Verb
segue	Verb
capisci	Verb
decide	Verb
capisce	Verb
apri	Verb
capisco	Verb
finisce	Verb
finisci	Verb
passiamo	Verb
decidiamo	Verb
prendiamo	Verb
prendono	Verb
prendi	Verb
colori	Noun
bianca	Adjetivos
bianche	Adjetivos
colore	Noun
rossa	Adjetivos
rossi	Adjetivos
arancione	Adjetivos
azzurri	Noun
domenica	Noun
ombrelli	Noun
nero	Adjetivos
usi	Verb
piace	Verb
piaccio	Verb
credi	Verb
crediamo	Verb
pensano	Verb
pensi	Verb
andiamo	Verb
sa	Verb
voglio	Verb
sappiamo	Verb
ho	Verb
ha	Verb
è	Verb
mangia	Verb
mangio	Verb
beve	Verb
bevi	Verb
bevono	Verb
sono	Verb
mangi	Verb
bevo	Verb
beviamo	Verb
